LEVEL:
8
BACKGROUND COLOR:
$70
PLAYFIELD COLOR:
$BA
FINISH COLOR:
$44
TIME:
$45
SCREEN:
--------------------
------XXXXXXXXXXX---
XXXXXXXXXXXXXXXXX---
XXXXXXXXXXXXXXXXX---
XXXXXXXXXXXXXXXXX---
XXXXXXXXXXXXXXXXX---
XXXXXXXXXXXXXXXXX---
XXXXXXXXXXXXXXXXX---
XXXXXXXXXXXXXXXXX---
------XXXXXXXXXXX---
--------------------
--------------------
X
X
1
X
RESET POS:
95
75
POWER UP TYPE:
0
ALTERNATE SCREEN MASK:
255
POWERUP:
0
0
0
ALTERNATE SCREEN:
0
NOCOLORS
SCREEN:
--------------------
--------------------
---XXXXXXXXXXXXXXXX-
---XXXXXXXXXXXXXXXX-
---XXXXXXXXXXXXXXXX-
---XXXXXXXXXXXXXXXX-
---XXXXXXXXXXXXXXXX-
---XXXXXXXXXXXXXXXX-
---XXXXXXXXXXXXXXXX-
---XXXXXXXXXXXX-----
---XXXXXXXXXXXX-----
---XXXXXXXXXXXX-----
X
2
X
0
RESET POS:
70
90
POWER UP TYPE:
0
ALTERNATE SCREEN MASK:
255
POWERUP:
0
0
0
ALTERNATE SCREEN:
0
NOCOLORS
SCREEN:
---XXXXXXXXXXXX-----
---XXXXXXXXXXXX-----
---XXXXXXXXXXXX-----
---XXXXXXXXXXXXXXXX-
---XXXXXXXXXXXXXXXX-
---XXXXXXXXXXXXXXXX-
---XXXXXXXXXXXXXXXX-
---XXXXXXXXXXXXXXXX-
---XXXXXXXXXXXXXXXX-
--------------------
--------------------
--------------------
1
X
X
3
RESET POS:
70
90
POWER UP TYPE:
HPWR20PTS
ALTERNATE SCREEN MASK:
255
POWERUP:
60
6
1
ALTERNATE SCREEN:
0
NOCOLORS
SCREEN:
-----XXXXXXXXXXXX---
-----XXXXXXXXXXXX---
-----XXXXXXXXXXXX---
XXXXXXXXXXXXXXXXX---
XXXXXXXXXXXXXXXXX---
XXXXXXXXXXXXXXXXX---
XXXXXXXXXXXXXXXXX---
XXXXXXXXXXXXXXXXX---
XXXXXXXXXXXXXXXXX---
--------------------
--------------------
--------------------
4
X
2
X
RESET POS:
70
90
POWER UP TYPE:
0
ALTERNATE SCREEN MASK:
255
POWERUP:
0
0
0
ALTERNATE SCREEN:
0
NOCOLORS
SCREEN:
--------------------
--------------------
XXXXXXXXXXXXXXXXX---
XXXXXXXXXXXXXXXXX---
XXXXXXXXXXXXXXXXX---
XXXXXXXXXXXXXXXXX---
XXXXXXXXXXXXXXXXX---
XXXXXXXXXXXXXXXXX---
XXXXXXXXXXXXXXXXX---
-----XXXXXXXXXXXX---
-----XXXXXXXXXXXX---
-----XXXXXXXXXXXX---
X
3
5
X
RESET POS:
70
90
POWER UP TYPE:
0
ALTERNATE SCREEN MASK:
255
POWERUP:
0
0
0
ALTERNATE SCREEN:
0
NOCOLORS
SCREEN:
--------------------
--------------------
XXXXXXXXXXXXXXXXXXX-
XXXXXXXXXXXXXXXXXXX-
XXXXXXXXXXXXXXXXXXX-
XXXXXXXXXXXXXXXXXXX-
XXXXXXXXXXXXXXXXXXX-
XXXXXXXXXXXXXXXXXXX-
XXXXXXXXXXXXXXXXXXX-
--------------------
--------------------
--------------------
X
X
6
4
RESET POS:
70
90
POWER UP TYPE:
0
ALTERNATE SCREEN MASK:
255
POWERUP:
0
0
0
ALTERNATE SCREEN:
0
NOCOLORS
SCREEN:
----XXXXXXXXXXX-----
----XXXXXXXXXXX-----
----XXXXXXXXXXXXXXX-
----XXXXXXXXXXXXXXX-
----XXXXXXXXXXXXXXX-
----XXXXXXXXXXXXXXX-
----XXXXXXXXXXXXXXX-
----XXXXXXXXXXXXXXX-
----XXXXXXXXXXXXXXX-
--------------------
--------------------
--------------------
7
X
X
5
RESET POS:
70
90
POWER UP TYPE:
HPWR20PTS
ALTERNATE SCREEN MASK:
255
POWERUP:
50
10
2
ALTERNATE SCREEN:
0
NOCOLORS
SCREEN:
--------------------
--------------------
--------------------
----XXXXXXXXXXXXXXX-
----XXXXXXXXXXXXXXX-
----XXXXXXXXXXXXXXX-
----XXXXXXXXXXXXXXX-
----XXXXXXXXXXXXXXX-
----XXXXXXXXXXXXXXX-
----XXXXXXXXXXX-----
----XXXXXXXXXXX-----
----XXXXXXXXXXX-----
X
6
X
8
RESET POS:
70
90
POWER UP TYPE:
0
ALTERNATE SCREEN MASK:
255
POWERUP:
0
0
0
ALTERNATE SCREEN:
0
NOCOLORS
SCREEN:
--------------------
--------------------
--------------------
XXXXXXXXXXXXXXXX----
XXXXXXXXXXXXXXXX----
XXXXXXXXXXXXXXXX----
XXXXXXXXXXXXXXXX----
XXXXXXXXXXXXXXXX----
XXXXXXXXXXXXXXXX----
-----XXXXXXXXXXX----
-----XXXXXXXXXXX----
-----XXXXXXXXXXX----
X
9
7
X
RESET POS:
70
90
POWER UP TYPE:
HPWR20PTS
ALTERNATE SCREEN MASK:
255
POWERUP:
60
2
4
ALTERNATE SCREEN:
0
NOCOLORS
SCREEN:
-----XXXXXXXXXXX----
-----XXXXXXXXXXX----
-----XXXXXXXXXXX----
-----XXXXXXXXXXX----
-----XXXXXXXXXXX----
-----XXXXXXXXXXX----
-----XXXXXXXXXXX----
-----XXXXXXXXXXX----
-----XXXXXXXXXXX----
-----XXXXXXXXXXX----
--------------------
--------------------
8
X
X
X
RESET POS:
70
40
POWER UP TYPE:
0
ALTERNATE SCREEN MASK:
255
POWERUP:
0
0
0
ALTERNATE SCREEN:
0
COLORS
X
$44
$44
X
X
X
ENDLEVEL
